{
    "tiles" : [[0, 0, 0, 0, 0, 0, 0, 0, 0 ],
               [0, 0, 0, 0, 0, 0, 0, 0, 0 ],
               [1, 1, 1, 1, 1, 1, 1, 1, 1 ],
               [1, 1, 1, 1, 1, 1, 1, 1, 1 ],
               [1, 1, 1, 1, 1, 1, 1, 1, 1 ],
               [1, 1, 1, 1, 1, 1, 1, 1, 1 ],
               [1, 1, 1, 1, 1, 1, 1, 1, 1 ],
               [1, 1, 1, 1, 1, 1, 1, 1, 1 ],
               [0, 0, 0, 0, 0, 0, 0, 0, 0 ] ],
    
    "enemyHP" : 1500,
    "enemyAttack" : 67,
    "enemyDefense" : 20,
    "enemyAI" : 1000,
    "enemyImage" : "Monstro2",
    "background" : "Background",
    
}